__________XXXX____G
_XX____XXXX_____XX_
__XX__XX_X_X_XXXXX_
_XXXX________XXXXXx
__S__XXXXXX________
___XXXXX_XX_X_XXXX_
____XXXX_____X_X_X_