__________XXXX____G
XXX____XXXX_____XX_
__XX__XX_X_X_XXXXX_
XXXXX________XXXXXx
__S___XXXXX________
___XXXXX_XX_X_XXXX_
____XXXX_____X_X_X_